"occ1990dd","occ1990dd_title","pctile_complexind","rank_pctile_complexind","complexsco","rank_complexsco","rank_complexsco_diff","R_PCA","rank_R_PCA","rank_R_PCA_diff","W_R_PCA","rank_W_R_PCA","rank_W_R_PCA_diff","High30","rank_High30","rank_High30_diff","High20","rank_High20","rank_High20_diff","High10","rank_High10","rank_High10_diff"
4," Chief executives, public administrators, and legislators",0.979307532310486,11,24.8728623069763,10,1,9.97280344600897,10,1,10.6417964243621,11,0,10.7647860704242,6,5,9.25284267519481,7,4,7.04329279393958,3,8
7,"Financial managers",0.961085259914398,27,23.1003649546981,28,1,7.54387865387709,27,0,8.0500845954454,27,0,8.16297583596911,21,6,6.57951582360339,28,1,4.83261735600596,22,5
8,"Human resources and labor relations managers",0.912861943244934,49,21.9923273072004,47,2,5.89488125475235,47,2,6.24607031960972,49,0,6.41180628547464,40,9,5.24946892207841,47,2,3.94664880917796,43,6
13," Managers and specialists in marketing, advert., PR",0.812625885009766,57,21.361887717247,56,1,5.26550834233643,55,2,5.48554741763645,57,0,5.8113256816557,50,7,5.24978481107164,46,11,4.03156570349832,41,16
14,"Managers in education and related fields",0.825332760810852,53,21.5907947729707,51,2,5.39776306617894,53,0,5.72938169776004,53,0,5.91171162655318,48,5,5.12751668214588,50,3,3.6193144131865,53,0
15,"Managers of medicine and health occupations",0.93297290802002,37,22.8736560018063,31,6,6.71394540838111,35,2,7.24946574804652,37,0,7.07651902958354,32,5,5.54709779379875,41,4,3.72364536899896,48,11
18,"Managers of properties and real estate",0.66233104467392,98,19.4812228835583,99,1,2.4289601048236,98,0,2.54017414757003,98,0,2.94723795525651,93,5,2.60344020811057,93,5,1.73390071874387,92,6
19,"Funeral directors",0.571892321109772,123,18.4153139105558,124,1,1.26719574996415,123,0,1.21369522845508,123,0,1.44845210337079,118,5,1.00951022533458,123,0,0.990170777327262,113,10
22," Managers and administrators, n.e.c.",0.908473491668701,51,21.8148016001701,49,2,5.68954641507253,51,0,6.08792068795754,51,0,5.89964622130774,49,2,4.88552209766895,53,2,3.55160922732296,54,3
23,"Accountants and auditors",0.78976982831955,61,21.3263206651688,57,4,5.02682866865613,60,1,5.36023707987193,61,0,5.37903639573503,58,3,4.15957641834976,63,2,3.09215169406824,62,1
24,"Insurance underwriters",0.653479993343353,101,19.581029984808,96,5,2.41970388010567,100,1,2.5147154018488,101,0,2.98813901399272,92,9,2.78032757601408,87,14,1.90127175918418,86,15
25,"Other financial specialists",0.752514719963074,71,20.9171810306072,70,1,4.42267568369968,71,0,4.67834731341497,71,0,4.84227539969655,65,6,3.90675038974068,64,7,2.93296844510881,64,7
26,"Management analysts",0.910030782222748,50,22.1035111904621,44,6,5.79990014846241,49,1,6.17734932320682,50,0,6.44433758927441,39,11,5.48306423845696,43,7,4.14571935313471,38,12
27," Personnel, HR, training, and labor rel. specialists",0.820043206214905,55,21.5573320409775,52,3,5.28352096883588,54,1,5.60536600539264,55,0,5.69421964254831,53,2,4.73599661106872,56,1,3.49400754232243,55,0
28,"Purchasing agents and buyers of farm products",0.653829216957092,100,19.5958250793934,95,5,2.37293547805008,102,2,2.51517894115354,100,0,2.67697559548321,99,1,1.55565260014564,113,13,1.0920124068927,110,10
29," Buyers, wholesale and retail trade",0.705725491046906,89,19.7449699333191,90,1,3.11234393158793,87,2,3.22499341208367,89,0,3.23782288406522,87,2,3.00456139199504,83,6,2.5443033160425,68,21
33," Purchasing managers, agents, and buyers, n.e.c.",0.799044251441956,59,21.292563466835,58,1,5.11338456029102,58,1,5.38040997009012,59,0,5.71985499881595,52,7,4.76206363371511,55,4,3.79368963645396,47,12
34,"Business and promotion agents",0.556446373462677,130,18.3289332324624,126,4,0.902037748582978,128,2,0.781268710823915,130,0,1.68150962184572,113,17,1.81568205787211,109,21,1.47751715488931,100,30
35,"Construction inspectors",0.679773807525635,91,19.6665011437178,93,2,2.9832373841184,91,0,3.12536706588186,91,0,2.92696716094913,95,4,2.76717771125948,88,3,2.32033053157014,72,19
36," Inspectors and compliance officers, outside",0.931180715560913,40,22.0812129089355,45,5,6.41299488399744,39,1,6.88266587521312,40,0,6.44999949282812,38,2,5.6680981620165,39,1,4.04978346755876,40,0
37,"Management support occupations",0.799309074878693,58,21.2893891196728,59,1,5.09905573766912,59,1,5.43079689249596,58,0,5.23526917112178,59,1,4.38969721197109,60,2,3.04362653192343,63,5
43,"Architects",0.969301521778107,19,23.5805702290535,21,2,8.1917947665298,19,0,8.81108811485836,19,0,8.47778155647586,18,1,7.07927402469263,21,2,4.55861453269832,28,9
44,"Aerospace engineers",0.997557938098907,6,25.7450720042706,6,0,10.5885815015639,6,0,11.4947388701062,6,0,10.5874148594516,7,1,8.83186339227757,8,2,6.07114596365855,10,4
45,"Metallurgical and materials engineers",0.995955944061279,7,25.2906609889984,7,0,10.1773678709115,7,0,11.0999409448171,7,0,10.0721146455564,9,2,8.47315788508111,9,2,5.52927950933656,14,7
47," Petroleum, mining, and geological engineers",0.969779908657074,18,23.8107899573326,17,1,8.28229342852695,18,0,8.96315055516162,18,0,8.27956820851326,20,2,6.91118609310374,22,4,4.7223979905852,24,6
48,"Chemical engineers",0.999585688114166,2,26.8705849354744,2,0,12.6915646096933,2,0,13.7579592365785,2,0,12.4271895179654,2,0,10.6562353785839,2,0,7.5484831033025,2,0
53,"Civil engineers",0.995513916015625,8,25.0650574568748,8,0,10.1206165873344,8,0,10.9526145679492,8,0,10.1818975935118,8,0,8.06274949677875,11,3,5.70763988748261,12,4
55,"Electrical engineers",0.941479384899139,33,22.8843392665863,30,3,6.87693179489581,33,0,7.46477075421475,33,0,6.77097157183823,34,1,5.58593131337101,40,7,3.71765107189241,49,16
56,"Industrial engineers",0.965312004089355,25,23.2272751824379,24,1,7.59625316153697,26,1,8.21834692414574,25,0,7.50022328295906,30,5,6.51339187685222,29,4,4.46205710406213,31,6
57,"Mechanical engineers",0.983074426651001,10,24.9712037350893,9,1,9.95087139215949,11,1,10.7508878291106,10,0,9.70937043338443,11,1,8.19560524505383,10,0,5.91206301868404,11,1
59," Engineers and other professionals, n.e.c.",0.978696882724762,12,24.6985910881281,12,0,9.57395860860436,12,0,10.3521892790292,12,0,9.50104580834133,12,0,7.92983657674743,12,0,5.69912724693737,13,1
64,"Computer systems analysts and computer scientists",0.928814291954041,41,22.3606525664091,39,2,6.36612817561946,41,0,6.86715522139319,41,0,6.1367621558042,44,3,5.20168167441488,48,7,3.63984119479272,50,9
65,"Operations and systems researchers and analysts",0.955541968345642,28,23.2281743039131,23,5,7.46819945564007,28,0,8.02284955601604,28,0,7.55852586328452,27,1,6.07635144252579,33,5,4.37110758350031,35,7
66,"Actuaries",0.997948825359344,4,26.1700040219307,3,1,11.3650873595655,4,0,12.2336499817213,4,0,11.8597542160491,3,1,9.4899724950113,4,0,6.9213773029355,4,0
68,"Mathematicians and statisticians",0.913231194019318,48,22.4483408955216,38,10,5.93188383603517,46,2,6.25964053521195,48,0,6.06838052842704,45,3,3.7664024813232,67,19,4.29774608753606,36,12
69,"Physicists and astronomists",1,1,28.1776495510101,1,0,14.4000123440261,1,0,15.6055922539746,1,0,14.3396191943131,1,0,11.9052070827334,1,0,7.68908255217219,1,0
73,"Chemists",0.973430693149567,13,24.2540544976711,13,0,8.88509140320881,13,0,9.66253213834189,13,0,8.59146434161185,15,2,7.19248751508922,19,6,4.69399397364647,25,12
74,"Atmospheric and space scientists",0.965846419334412,23,23.3528160311222,22,1,7.81863281175345,23,0,8.40659551184326,23,0,7.50245788370497,29,6,6.84156227340245,23,0,4.89092953370719,21,2
75,"Geologists",0.971912741661072,14,24.1266092372894,14,0,8.68869628720479,14,0,9.40255297461615,14,0,8.56182306374734,16,2,7.21386307091625,17,3,5.09419457298874,19,5
76," Physical scientists, n.e.c.",0.965977549552917,22,23.6412189992905,20,2,7.93100399626648,22,0,8.5158106229849,22,0,7.82781049971879,25,3,6.81090591344229,24,2,5.11831086782565,18,4
77,"Agricultural and food scientists",0.97116881608963,15,24.0390939175129,15,0,8.52414162832822,15,0,9.20673616401448,15,0,8.64895399243376,14,1,7.5340147187658,16,1,5.27478323643442,16,1
78,"Biological scientists",0.998529970645905,3,26.0395579338551,4,1,11.4095330428826,3,0,12.3803972356161,3,0,11.3458195166589,4,1,9.88688908656045,3,0,6.53736105086987,7,4
79,"Foresters and conservation scientists",0.820612907409668,54,21.5307034178495,53,1,5.25562994747269,56,2,5.63145076854862,54,0,5.20721350831843,60,6,4.49423482880948,58,4,3.09713157215945,61,7
83,"Medical scientists",0.997801661491394,5,25.7823343183994,5,0,10.8577260620421,5,0,11.7764166987619,5,0,10.9298914747053,5,0,9.34820894872711,6,1,6.55273808596353,6,1
84,"Physicians",0.991811215877533,9,24.731556000495,11,2,10.0344084829581,9,0,10.857940621636,9,0,10.0104376240066,10,1,9.35743207075932,5,4,6.66436404261505,5,4
85,"Dentists",0.943484902381897,32,22.627862563777,34,2,6.94412221790259,32,0,7.50454393411663,32,0,7.02800221255112,33,1,6.34804269613535,31,1,4.40123477576272,34,2
86,"Veterinarians",0.925707697868347,43,22.1188031446457,43,0,6.06794747399549,43,0,6.54774450773905,43,0,5.99665656813616,47,4,5.79276566043558,38,5,3.96038721888878,42,1
87,"Optometrists",0.965714275836945,24,22.9393089073896,29,5,7.72179524796017,24,0,8.3359636633044,24,0,7.51172041641102,28,4,7.20931981298656,18,6,5.13016927571718,17,7
88,"Podiatrists",0.966097474098206,21,23.1157068777323,27,6,7.97833815571202,21,0,8.54785596078628,21,0,7.82913048129946,24,3,7.775628610184,13,8,6.19603815737526,9,12
89,"Other health and therapy occupations",0.918158710002899,45,21.7023294614315,50,5,5.93558854810697,45,0,6.36370956995377,45,0,5.74016320383007,51,6,5.91764591124515,37,8,4.44358846323868,32,13
95,"Registered nurses",0.9356369972229,34,22.5296495018721,35,1,6.82550743992493,34,0,7.41377455551758,34,0,6.74599283081642,35,1,6.02276258366154,35,1,3.93596715387848,44,10
96,"Pharmacists",0.94562429189682,31,22.7027189067364,33,2,6.98450966517549,31,0,7.54061699252716,31,0,7.07907599064571,31,0,6.06372713735955,34,3,4.11140703333,39,8
97,"Dieticians and nutritionists",0.931894779205322,38,22.2131791153908,42,4,6.4798246384598,38,0,6.89797547708198,38,0,6.35531960326772,41,3,6.26404920781546,32,6,4.46432985223534,30,8
98,"Respiratory therapists",0.758894085884094,69,20.9840570404768,67,2,4.46552830079502,70,1,4.87577675915999,69,0,4.21527684027743,73,4,3.46542014563062,73,4,2.13172353194338,78,9
99,"Occupational therapists",0.744203925132751,73,20.4927006488323,76,3,4.08848639787907,73,0,4.32810809411849,73,0,4.12752713320982,74,1,3.84236142346957,66,7,2.75153922823302,65,8
103,"Physical therapists",0.825542986392975,52,21.4389870895386,55,3,5.46914237415401,52,0,5.85530400189797,52,0,5.47233797969847,57,5,5.18297920478643,49,3,3.42521332158265,56,4
104,"Speech therapists",0.925784826278687,42,21.9800415109873,48,6,6.38776809241954,40,2,6.77453242464093,42,0,6.32224673185927,42,0,6.39720040845538,30,12,4.80574627503527,23,19
105," Therapists, n.e.c.",0.744180262088776,74,20.5320643084288,75,1,4.03956519732253,74,0,4.32040712320942,74,0,4.07294287209803,75,1,3.84275379757709,65,9,2.49730620165543,69,5
106,"Physicians' assistants",0.933385729789734,36,22.4903131153584,37,1,6.69590232667372,37,1,7.29233663925562,36,0,6.50906180197947,37,1,5.49653725169049,42,6,3.88740445407531,45,9
154," Subject instructors, college",0.925038039684296,44,22.2157393942356,41,3,6.03450103498566,44,0,6.40446441907565,44,0,6.65029104139036,36,8,5.97264923497712,36,8,4.43069770680067,33,11
155,"Kindergarten and earlier school teachers",0.531381785869598,141,17.6314650305659,138,3,0.272790721637673,139,2,0.160353815455239,141,0,0.512526638992305,134,7,0.783524791515224,129,12,0.302828089530301,135,6
156,"Primary school teachers",0.715056657791138,88,19.903738206172,88,0,3.06590516804066,89,1,3.23616999506832,88,0,3.31029093272783,86,2,2.74593591238823,91,3,1.73200473440195,93,5
157,"Secondary school teachers",0.740188419818878,77,20.5723019637585,74,3,4.0204660445381,76,1,4.27289999127067,77,0,4.36012094974788,70,7,3.49847922312278,72,5,2.12925996564828,79,2
158,"Special education teachers",0.731264054775238,81,20.2675847747087,80,1,3.67479180507384,80,1,3.88053713681462,81,0,4.00073520735335,76,5,3.35531372879746,75,6,2.06376736736949,81,0
159," Teachers, n.e.c.",0.721664488315582,83,20.0492382688284,83,0,3.43041438206765,83,0,3.59587507920663,83,0,3.6667512786633,78,5,3.37611514303054,74,9,2.30428662294179,74,9
163,"Vocational and educational counselors",0.762110352516174,67,20.9421147224188,68,1,4.82921708233771,64,3,5.05448151368422,67,0,5.0465337192832,64,3,5.30338619710279,44,23,4.2215373758597,37,30
164,"Librarians",0.67799586057663,95,19.5428309552193,97,2,2.88824079801477,94,1,3.01287816443562,95,0,3.12663868381848,89,6,3.03148642509894,81,14,2.05672911428003,82,13
165,"Archivists and curators",0.740328669548035,76,20.5891485126019,73,3,4.03161178544118,75,1,4.31329051153468,76,0,4.23582646862996,72,4,3.5507901075875,70,6,2.04022257170168,83,7
166," Economists, market and survey researchers",0.967446386814117,20,23.8036982460022,18,2,8.03601074656656,20,0,8.6262008053738,20,0,8.34956867427113,19,1,6.63717010993731,26,6,4.56176310385164,27,7
167,"Psychologists",0.970644891262054,17,23.6740103298664,19,2,8.31959698423798,17,0,8.96812325845504,17,0,8.50757907881468,17,0,7.70695361796949,15,2,5.47926242488258,15,2
169," Social scientists and sociologists, n.e.c.",0.95443469285965,29,23.1681140498877,25,4,7.35253227205592,29,0,7.89529326333124,29,0,7.6421311847507,26,3,6.73043894596971,25,4,4.57242139961047,26,3
173,"Urban and regional planners",0.970815479755402,16,23.9856209424973,16,0,8.44842928859457,16,0,9.08260595634908,16,0,8.6551419553712,13,3,7.11970393152206,20,4,4.93162683659407,20,4
174,"Social workers",0.778459787368774,62,21.0766459522486,65,3,4.99893014357139,61,1,5.30697864709704,62,0,5.05726847005535,63,1,4.96224133006269,52,10,3.62637243081376,52,10
176,"Clergy and religious workers",0.758501291275024,70,20.7910654624939,71,1,4.59696147115277,68,2,4.78383645990079,70,0,5.18901234427598,62,8,4.46925955365958,59,11,3.34194465365965,57,13
177,"Welfare service workers",0.620351850986481,112,19.0527737353921,109,3,1.92970546414389,111,1,1.96906990645658,112,0,2.17603843660103,106,6,2.39944135498982,97,15,1.83093183993351,89,23
178,"Lawyers and judges",0.95427393913269,30,22.7893217183828,32,2,7.30742369206028,30,0,7.76871571992814,30,0,8.02282828601959,22,8,7.75887833145263,14,16,6.23083757454953,8,22
183,"Writers and authors",0.639497935771942,105,19.1420815726399,105,0,2.26709842965044,105,0,2.30491598407202,105,0,2.61697788026471,101,4,3.21563619007787,78,27,1.56652982582362,98,7
184,"Technical writers",0.535057663917542,137,17.9142479692936,135,2,0.43051034800525,135,2,0.320491247414958,137,0,0.940072599241835,126,11,2.45923860303498,96,41,1.04351380644145,111,26
185,"Designers",0.626071214675903,110,18.9744733287454,111,1,1.96656286905855,109,1,2.03071147548673,110,0,2.14551823887737,107,3,2.18266676987686,104,6,1.13788682943117,108,2
186,"Musicians and composers",0.429997801780701,170,16.7414411362708,172,2,-0.861332098785639,167,3,-1.12742102520949,170,0,-0.572426933413426,155,15,0.0997202045955757,149,21,-0.393096486455287,159,11
187," Actors, directors, and producers",0.67894583940506,92,19.6342785399854,94,2,2.98878188780702,90,2,3.09829332166826,92,0,3.41041082804293,84,8,3.33368527188611,76,16,2.16084337269449,76,16
188," Painters, sculptors, craft-artists, and print-makers",0.570529997348785,125,18.4316219157875,121,4,1.1088742805059,124,1,1.12126042261258,125,0,1.46007291851117,117,8,1.26720851490166,118,7,0.244062782749061,137,12
189,"Photographers",0.532622039318085,140,17.5554898969173,142,2,0.206227362147124,141,1,0.178891909688155,140,0,-0.027220832928257,142,2,0.823401697610292,128,12,-0.319416558770155,155,15
193,"Dancers",0.372030109167099,187,16.066812296468,188,1,-1.76690678874091,185,2,-2.06897223868952,187,0,-1.55188734860942,176,11,-0.742705363394207,166,21,-1.22121433692741,186,1
194,"Art/entertainment performers and related occs",0.568570137023926,127,18.1369388711095,131,4,1.05257739326814,126,1,1.04609699144158,127,0,1.32898931880998,121,6,1.80422731863805,111,16,0.501693691545955,130,3
195,"Editors and reporters",0.641386330127716,104,18.9355042484581,112,8,2.23287104344298,106,2,2.3077211146056,104,0,2.37962861066561,104,0,2.64487695662155,92,12,1.56505532261389,99,5
198,"Announcers",0.522479355335236,145,17.3823380671702,146,1,-0.0598428782041155,145,0,-0.172048547636935,145,0,0.459876246895184,135,10,0.600308927708482,134,11,-0.0321263097216974,145,0
199," Athletes, sports instructors, and officials",0.534489154815674,138,17.519509937644,143,5,0.434066193725921,134,4,0.296426800620481,138,0,0.36838107838586,137,1,0.75814794369547,130,8,0.829618407653669,119,19
203,"Clinical laboratory technologies and technicians",0.732358455657959,80,20.119384641242,81,1,3.58809021040223,81,1,3.93336915427787,80,0,3.03986761500766,90,10,2.60067110192164,94,14,1.28643463115608,105,25
204,"Dental hygienists",0.535067617893219,136,17.8783799741387,136,0,0.316521749363769,137,1,0.355549038984152,136,0,0.012283444295438,140,4,0.459263393695777,138,2,0.0632018394523567,143,7
205,"Health record technologists and technicians",0.345607757568359,201,16.0014609533072,193,8,-2.24678125821106,203,2,-2.48207343804533,201,0,-2.23459676863736,192,9,-1.54144582211674,182,19,-1.77232039996815,206,5
206,"Radiologic technologists and technicians",0.662828207015991,97,19.3635037335396,102,5,2.42436740478754,99,2,2.6533816651486,97,0,1.97934423054797,110,13,1.648575309518,112,15,0.855094039537824,117,20
207,"Licensed practical nurses",0.719456613063812,85,19.992554113698,84,1,3.18787514676019,86,1,3.46339037152424,85,0,3.01565473785229,91,6,2.59435050273304,95,10,1.67836502898273,96,11
208," Health technologists and technicians, n.e.c.",0.733848631381989,78,20.3939865395784,79,1,3.85544597252229,78,0,4.17255413074805,78,0,3.65645794550051,79,1,3.25242565829652,77,1,2.13837380927651,77,1
214,"Engineering technicians",0.774634778499603,64,21.1060726633072,63,1,4.81246076991328,65,1,5.21735248827845,64,0,4.47444172498955,68,4,3.50097967816769,71,7,2.38663049127912,71,7
217,"Drafters",0.646362006664276,103,19.2190020595312,104,1,2.29249198708499,103,0,2.36488030384481,103,0,2.18096894061495,105,2,2.12511615446206,106,3,1.44330828050654,103,0
218," Surveryors, cartographers, mapping scientists/techs",0.760643780231476,68,21.000555764842,66,2,4.56355494405384,69,1,4.92768870613865,68,0,4.32055744548124,71,3,2.90780487217387,85,17,1.7207076440846,94,26
223,"Biological technicians",0.732833385467529,79,20.4709036281586,77,2,3.76477133171297,79,0,4.07626179053799,79,0,3.44302134618731,83,4,2.8488191204927,86,7,1.8639918986782,88,9
224,"Chemical technicians",0.775659382343292,63,21.1946479511499,61,2,4.77016005987491,66,3,5.22776505741092,63,0,4.58609708758751,66,3,3.17645732990805,79,16,1.8176872517546,90,27
225,"Other science technicians",0.626931488513947,109,19.0698225388765,108,1,1.95332529709737,110,1,2.08055001543909,109,0,1.42839393173953,119,10,1.43303963839517,114,5,0.955900097435972,114,5
226,"Airplane pilots and navigators",0.934673249721527,35,22.2783998055935,40,5,6.70587456027998,36,1,7.31889818608293,35,0,6.23152447685427,43,8,5.26104131216362,45,10,3.81240683365808,46,11
227,"Air traffic controllers",0.913858532905579,47,21.5213640495777,54,7,5.79818874869718,50,3,6.28552197061383,47,0,5.62860259893839,54,7,4.97373883416589,51,4,3.2911842979184,58,11
228,"Broadcast equipment operators",0.573939561843872,121,18.4251560561657,122,1,1.33187893772937,120,1,1.39919267911988,121,0,1.09633601717631,125,4,1.28751160638399,117,4,0.542137291749969,128,7
229,"Computer software developers",0.917843818664551,46,22.0474807260036,46,0,5.87192022009302,48,2,6.32657418755035,46,0,5.54404212392759,55,9,4.872308667495,54,8,3.2222258458744,59,13
233,"Programmers of numerically controlled machine tools",0.678124248981476,94,19.5281124927521,98,4,2.81552357453325,95,1,3.036404856953,94,0,2.03315308097949,109,15,1.25720485940279,119,25,0.865406987542883,116,22
234,"Legal assistants and paralegals",0.43074357509613,168,16.8550761763215,165,3,-0.853984213468191,165,3,-1.06313293915757,168,0,-0.600989961615681,158,10,0.234563806315878,146,22,0.0508661959973837,144,24
235," Technicians, n.e.c.",0.748371124267578,72,20.6254954904556,72,0,4.14705484331243,72,0,4.47177593500347,72,0,3.77659623699174,77,5,3.01544602389221,82,10,1.94697864074978,85,13
243,"Sales supervisors and proprietors",0.703937232494354,90,19.8176988593936,89,1,3.07748198108758,88,2,3.17375920270933,90,0,3.49410687224243,81,9,2.75351320095703,89,1,2.18462623934168,75,15
253,"Insurance sales occupations",0.636313199996948,107,19.2338158880234,103,4,2.18455327601378,107,0,2.26876900203245,107,0,2.59415188180073,102,5,2.0902168508774,107,0,1.45221012691781,102,5
254,"Real estate sales occupations",0.660330772399902,99,19.4361207132339,100,1,2.45501960705543,97,2,2.53521842709473,99,0,2.8798477220019,96,3,2.36874991610302,99,0,1.89434094005184,87,12
255,"Financial service sales occupations",0.766071617603302,65,21.2434186267436,60,5,4.92172933712228,63,2,5.20311590380032,65,0,5.50295308135052,56,9,4.61801916708944,57,8,3.62686338561904,51,14
256,"Advertising and related sales jobs",0.628106713294983,108,19.0727840847015,107,1,2.26900723495662,104,4,2.25593311223674,108,0,2.62683026994789,100,8,2.37499944902266,98,10,1.71242494136793,95,13
258,"Sales engineers",0.961903393268585,26,23.1242020111799,26,0,7.62148875949931,25,1,8.15367327768834,26,0,7.92604864499882,23,3,6.59374741646576,27,1,4.47256019179605,29,3
274," Salespersons, n.e.c.",0.500577628612518,152,17.378755358094,148,4,-0.215743335927026,147,5,-0.440347233554567,152,0,0.208785537542234,138,14,0.619042200392054,132,20,0.495635790771094,132,20
275,"Retail salespersons and sales clerks",0.49662047624588,157,17.0877003119588,155,2,-0.568453914078458,157,0,-0.726075903304136,157,0,-0.425893890386537,150,7,-0.501770445867257,158,1,-0.483868543193231,163,6
276,"Cashiers",0.168038263916969,265,13.7538180597663,272,7,-4.95494748934859,264,1,-5.47096461448915,265,0,-5.02127881073868,263,2,-4.49185935111114,269,4,-3.03475921836217,253,12
277," Door-to-door sales, street sales, and news vendors",0.0641871467232704,287,13.2219670356393,285,2,-5.72231230446909,282,5,-6.64727244044468,287,0,-4.96736214274994,262,25,-2.38666017913509,207,80,-1.21453113341134,185,102
283," Sales demonstrators, promoters, and models",0.0338789820671082,306,11.6132346429169,305,1,-7.83239509204489,303,3,-8.76217338188431,306,0,-7.90098416225012,300,6,-5.71035863470148,293,13,-3.83081451042701,286,20
303,"Office supervisors",0.653347849845886,102,19.4223670218229,101,1,2.40503195683619,101,1,2.48635990373245,102,0,2.80351109690803,98,4,2.19070132502015,103,1,1.74295609149627,91,11
308,"Computer and peripheral equipment operators",0.743946552276611,75,20.4261730346203,78,3,3.95013327226429,77,2,4.31956779795919,75,0,3.33553828223087,85,10,2.75154760715797,90,15,1.62611934957907,97,22
313,"Secretaries and stenographers",0.419288069009781,177,16.577293871969,176,1,-1.27150499212765,175,2,-1.49155813570014,177,0,-1.21408782310659,169,8,-0.81887277553215,168,9,-0.657895696193212,170,7
315,"Typists",0.11390370875597,280,13.4798470816657,278,2,-5.54411441563557,278,2,-6.06360158072376,280,0,-5.64522571689074,275,5,-5.02107908734764,281,1,-4.00014257614134,291,11
316," Interviewers, enumerators, and surveyors",0.371295571327209,189,16.1188165449619,187,2,-1.81033802927534,187,2,-2.14892825905846,189,0,-1.56945454326529,177,12,-0.994003676919171,173,16,-0.269273898007749,152,37
317,"Hotel clerks",0.304226011037827,226,15.214501081419,227,1,-3.00376931760737,222,4,-3.42805208632225,226,0,-3.08703943982786,216,10,-2.61404676899919,216,10,-1.5010869487832,194,32
318,"Transportation ticket and reservation agents",0.501694440841675,150,17.3350920472145,150,0,-0.266177394691921,152,2,-0.42497569954249,150,0,-0.000761506469370551,141,9,0.247105344222324,144,6,-0.098847054611469,149,1
319,"Receptionists and other information clerks",0.335727661848068,212,15.5626031393766,212,0,-2.6969053916325,211,1,-3.00172922552382,212,0,-2.74703948587401,212,0,-2.56038893240945,213,1,-2.05467336969887,214,2
326,"Correspondence and order clerks",0.344721883535385,203,15.5491522242472,214,11,-2.10612113805759,196,7,-2.52833819468494,203,0,-2.35060546952745,197,6,-1.30856106161249,180,23,-0.647392499687082,169,34
328," Human resources clerks, excl payroll and timekeeping",0.435491532087326,162,17.0258379600406,159,3,-0.789754322063385,162,0,-0.945761876560711,162,0,-0.77999854336969,161,1,-0.641984244232603,161,1,-0.458692561039172,160,2
329,"Library assistants",0.337690532207489,209,15.6724275735855,207,2,-2.56827981862777,209,0,-2.82450950315172,209,0,-2.74575582277433,211,2,-2.5553347551129,212,3,-2.15756150352375,221,12
335,"File clerks",0.338747143745422,207,15.6538680209279,208,1,-2.51770393265129,208,1,-2.75633918386961,207,0,-2.67010012813656,209,2,-2.35799120842041,204,3,-2.46910480500502,231,24
336,"Records clerks",0.500904440879822,151,17.2224300513029,154,3,-0.256058696994182,149,2,-0.436477884289087,151,0,-0.279274320241665,147,4,-0.510454981613185,159,8,0.131431859257099,141,10
337,"Bookkeepers and accounting and auditing clerks",0.521911263465881,146,17.3817040148303,147,1,-0.119274951637745,146,0,-0.239059144346137,146,0,-0.0763295367775003,143,3,-0.315234625908892,153,7,-0.195526233026146,150,4
338,"Payroll and timekeeping clerks",0.34017488360405,205,15.9302190113708,200,5,-2.16783714941804,199,6,-2.56859744181425,205,0,-1.92435430267864,188,17,-1.27168452865506,178,27,-0.722842886661163,172,33
344,"Billing clerks and related financial records processing",0.345583409070969,202,15.9648714565277,197,5,-2.30878334685328,205,3,-2.52185988079128,202,0,-2.34812715322418,196,6,-2.36472033249179,205,3,-2.05015988548307,213,11
346,"Mail and paper handlers",0.0528621859848499,295,12.4467771279022,295,0,-6.83656894393664,294,1,-7.5095189042562,295,0,-7.16883861869027,295,0,-6.14540806720308,298,3,-3.8724357849824,287,8
347," Office machine operators, n.e.c.",0.323997318744659,218,15.5583242019415,213,5,-2.83750753560796,219,1,-3.12022114752749,218,0,-3.05802982473089,215,3,-3.27215797813248,231,13,-2.28971516882721,224,6
348,"Telephone operators",0.129552632570267,272,13.8895170503736,267,5,-5.15834002598408,272,0,-5.66692571550854,272,0,-5.18212639169622,265,7,-4.19903769185718,259,13,-3.17943320808331,265,7
354," Postal clerks, exluding mail carriers",0.303054392337799,228,14.96831105299,233,5,-3.28228051880808,227,1,-3.62481689521106,228,0,-3.44000229361643,226,2,-3.11349383042598,227,1,-2.10061350441608,217,11
355,"Mail carriers for postal service",0.0521170757710934,297,12.4814611000821,294,3,-6.89678947326643,297,0,-7.57144046903532,297,0,-7.10482055610169,293,4,-5.54176126546166,289,8,-3.50093563053281,279,18
356," Mail clerks, outside of post office",0.115207999944687,279,13.4944991481185,276,3,-5.56386514620415,279,0,-6.05933855574355,279,0,-5.86629739843789,281,2,-4.95679719009574,280,1,-3.82449355348061,285,6
357,"Messengers",0.130375191569328,271,13.9507291140005,264,7,-5.13310066427218,271,0,-5.65483811330289,271,0,-5.20694664702747,266,5,-4.5354422341056,272,1,-3.53688008650614,280,9
359,"Dispatchers",0.573216140270233,122,18.4192979944348,123,1,1.33243747273487,119,3,1.39748579388482,122,0,1.24744724125626,122,0,0.915101071740842,125,3,0.468165039470729,133,11
364,"Shipping and receiving clerks",0.444751530885696,161,17.0478464952707,158,3,-0.767269949260813,160,1,-0.905966272563833,161,0,-0.617177940616042,160,1,-0.777514415121758,167,6,-0.637777707593259,166,5
365,"Stock and inventory clerks",0.0705000981688499,286,13.1865380700283,286,0,-5.93758679010297,287,1,-6.56505718142348,286,0,-5.90391521819263,282,4,-4.76482619385836,277,9,-3.13903046702537,261,25
366,"Meter readers",0.325161218643188,216,15.722363173227,204,12,-2.83542315171711,218,2,-3.08223297074144,216,0,-3.02031215215631,214,2,-3.14384429517097,229,13,-2.42126696333227,229,13
368," Weighers, measurers, and checkers",0.325987160205841,215,15.3708910799026,221,6,-2.74554739226426,213,2,-3.07528717508763,215,0,-3.23219584628734,223,8,-2.89704509422234,222,7,-1.87110523089117,207,8
373," Material recording, sched., prod., plan., expediting cl",0.719203889369965,86,19.9466021061778,86,0,3.24336924031585,84,2,3.40281680725572,86,0,3.61537490267669,80,6,3.11649554531928,80,6,2.3166633316077,73,13
375," Insurance adjusters, examiners, and investigators",0.533844709396362,139,17.6222763199031,139,0,0.291172577699286,138,1,0.210530265186838,139,0,0.405443725409715,136,3,0.46155059901393,137,2,0.753376223751048,121,18
376," Customer service reps, invest., adjusters, excl. insur.",0.619934737682343,114,18.8178800113797,114,0,1.68576777312461,115,1,1.7481932829859,114,0,1.83886336792888,111,3,1.41174122257948,115,1,0.931228797621296,115,1
377," Eligibility clerks for government prog., social welfare",0.448247402906418,158,17.0225780745983,160,2,-0.52390081108654,154,4,-0.77905943352574,158,0,-0.296956678511454,148,10,1.04876187599515,122,36,1.09439503646324,109,49
378,"Bill and account collectors",0.448174327611923,159,16.9472129331872,161,2,-0.610176315594473,159,0,-0.852592345636182,159,0,-0.358075401020608,149,10,0.210455909207809,148,11,0.292626791213068,136,23
379,"General office clerks",0.248534813523293,250,14.2624090025902,257,7,-4.19728631551295,248,2,-4.69056295412681,250,0,-4.36623152534569,245,5,-3.49988385991778,236,14,-2.62935224590179,240,10
383,"Bank tellers",0.371994286775589,188,16.0388161256358,189,1,-1.80084781580852,186,2,-2.0870231049492,188,0,-1.67721999361439,182,6,-1.63247151446701,186,2,-0.898152254045843,177,11
384,"Proofreaders",0.172041937708855,262,14.3053820185244,253,9,-4.80326921737816,262,0,-5.193685216349,262,0,-4.81820430046842,257,5,-4.21525807607391,261,1,-3.4324573704641,275,13
385,"Data entry keyers",0.324487090110779,217,15.3670091216207,222,5,-2.81384895600235,217,0,-3.11238264670878,217,0,-3.33536347431522,225,8,-3.03677621199311,225,8,-2.38577679034586,227,10
386,"Statistical clerks",0.93177455663681,39,22.520011694169,36,3,6.34156955485013,42,3,6.89576139911745,39,0,6.01196706790487,46,7,4.38747126046195,61,22,2.48305050924222,70,31
387,"Teacher's aides",0.337855368852615,208,15.7004969337821,205,3,-2.47741173522199,207,1,-2.81587049693113,208,0,-2.4224282224829,201,7,-1.65262019904534,188,20,-1.60982800575977,197,11
389," Administrative support jobs, n.e.c.",0.414857804775238,181,16.4896805858374,179,2,-1.46943923078104,179,2,-1.7190542021409,181,0,-1.38142503344666,174,7,-0.598877142040487,160,21,-0.310189277129605,154,27
405," Housekeepers, maids, butlers, and cleaners",0.027679992839694,312,11.0420309955835,312,0,-9.23571883399308,312,0,-10.058227768253,312,0,-9.44442469363536,312,0,-8.06392453488898,314,2,-5.55958044617956,313,1
408,"Laundry and dry cleaning workers",0.0338383130729198,307,11.3929639375329,308,1,-8.09956748587962,306,1,-8.95672039971413,307,0,-8.44839557405946,307,0,-6.62072029805624,302,5,-4.28074834751881,296,11
417," Fire fighting, fire prevention, and fire inspection occ",0.795349061489105,60,21.0782677711248,64,4,4.92650761254274,62,2,5.36538389391134,60,0,4.58504090652929,67,7,3.75942417865468,68,8,2.55902106147554,67,7
418," Police and detectives, public service",0.731094658374786,82,20.0681211083651,82,0,3.55054218263303,82,0,3.83753783883537,82,0,3.4656449041675,82,0,2.9316572845396,84,2,1.96139755789325,84,2
423," Sheriffs, bailiffs, correctional institution officers",0.435336023569107,163,16.8712525178671,164,1,-0.877230422770597,168,5,-0.9583640905172,163,0,-0.987637674916574,166,3,-0.659642323336333,162,1,-0.352603625947562,156,7
425,"Crossing guards",0.0277429576963186,311,11.1544101050258,311,0,-8.43543230378557,311,0,-9.28710969994028,311,0,-8.50019075148892,308,3,-5.84172117745865,296,15,-4.06747810174424,292,19
426," Guards and police, except public service",0.518875241279602,147,17.289351342243,152,5,-0.265584781642954,151,4,-0.260206225937611,147,0,-0.446345667762708,151,4,-0.226889846123731,151,4,-0.459343929132857,161,14
427," Protective service, n.e.c.",0.432865381240845,164,16.7715386717558,169,5,-0.857199205060497,166,2,-0.959748461348969,164,0,-1.14357299559027,167,3,-0.39654641204773,155,9,-0.464212906280475,162,2
433,"Supervisors of food preparation and service",0.4247807264328,173,16.4157341479465,181,8,-0.845932774423064,164,9,-1.23387449296549,173,0,-0.869868729623504,164,9,-0.352171653452285,154,19,0.844632853053359,118,55
434,"Bartenders",0.342877626419067,204,15.6990140208244,206,2,-2.28886842550577,204,0,-2.55053652917752,204,0,-2.39350154112598,199,5,-2.33143718705111,202,2,-1.87748969101668,208,4
435,"Waiters and waitresses",0.0361711084842682,305,11.522434968245,306,1,-7.88715678530993,304,1,-8.74813407342758,305,0,-8.17706629837621,304,1,-6.87784669815305,307,2,-4.55658730407034,302,3
436,"Cooks",0.290647119283676,235,14.7997032155514,235,0,-3.62079241835002,235,0,-4.05262821639808,235,0,-3.54087230525885,228,7,-3.14129196469801,228,7,-2.20239903602963,222,13
439,"Food preparation workers",0.00225508376024663,315,9.8064620375514,315,0,-10.5571842904751,315,0,-11.5907777830648,315,0,-10.8468065738672,315,0,-8.86324783321099,315,0,-6.23262234064548,315,0
444,"Miscellanious food preparation and service workers",0.0467313937842846,299,12.1142617935538,299,0,-7.39639423151472,299,0,-8.13980745560363,299,0,-7.61659021802203,298,1,-6.79423442132581,304,5,-4.75363508953946,305,6
445,"Dental Assistants",0.496668994426727,156,17.3195778983355,151,5,-0.597109927495999,158,2,-0.630921598678469,156,0,-0.57498057208212,156,0,-0.699864195513373,165,9,-0.63861680655761,168,12
447,"Health and nursing aides",0.42807924747467,172,16.7778548330665,168,4,-1.11981482494608,173,1,-1.22368051764511,172,0,-1.31352930757617,171,1,-1.04708697456776,174,2,-0.886416186332208,176,4
448,"Supervisors of cleaning and building service",0.323722422122955,219,15.4604630264089,217,2,-2.7552849659823,214,5,-3.15179930138598,219,0,-2.56271430047874,206,13,-2.1774481894196,198,21,-1.29032799300914,190,29
450," Superv. of landscaping, lawn service, groundskeeping",0.556189239025116,131,18.1604719599009,130,1,0.751961669754801,131,0,0.732475998730752,131,0,0.881897132956434,129,2,0.615483288523159,133,2,0.571104538234905,127,4
451,"Gardeners and groundskeepers",0.238642960786819,254,14.4008425796032,248,6,-4.49891553952915,255,1,-4.88976088253057,254,0,-4.69444288563664,252,2,-3.97192914319843,249,5,-3.13834617075877,260,6
453,"Janitors",0.0249186623841524,314,10.2306439306736,314,0,-9.70456745353863,314,0,-10.6130293488371,314,0,-10.1782710058951,314,0,-7.21603985137884,310,4,-5.3716407177336,312,2
455,"Pest control occupations",0.418399631977081,178,16.5252980157375,178,0,-1.28262381822554,176,2,-1.49230825315878,178,0,-1.72259373091208,184,6,-1.29532660602877,179,1,-0.869006716586938,175,3
457,"Barbers",0.0562024004757404,292,12.6933371482134,290,2,-6.55334674129664,292,0,-7.27755835093745,292,0,-6.31433408348545,286,6,-4.43723907233929,268,24,-3.04896012753199,255,37
458,"Hairdressers and cosmetologists",0.162420824170113,268,13.8528442763448,269,1,-5.04814193508177,266,2,-5.59472193300839,268,0,-5.11623709926867,264,4,-3.82221933317164,243,25,-2.74752129298424,244,24
459,"Recreation facility attendants",0.117358699440956,277,13.4193987695813,281,4,-5.40138273595934,274,3,-5.98320651238313,277,0,-5.47737838903952,272,5,-4.20751351548388,260,17,-2.84024837902611,248,29
461,"Guides",0.335174292325974,213,15.4841645088196,216,3,-2.5931335731556,210,3,-3.01222629008782,213,0,-2.31984730266569,193,20,-1.58753686897915,184,29,-1.02372306744763,181,32
462,"Ushers",0.0362983494997025,304,11.6993819452763,303,1,-7.88944772139167,305,1,-8.72358119010645,304,0,-8.175195179611,303,1,-6.79655320053958,305,1,-4.63852162776966,304,0
464," Baggage porters, bellhops and concierges",0.269680440425873,244,14.5570134785175,245,1,-3.98366388844744,242,2,-4.44310768903552,244,0,-3.86886581860276,233,11,-3.41178963481959,234,10,-2.72850141842172,243,1
466,"Recreation and fitness workers",0.355665117502213,194,16.0084974487782,192,2,-1.89718927444128,190,4,-2.24633849937295,194,0,-1.90475403387206,187,7,-0.670455487157882,164,30,-0.364318327040577,158,36
467,"Motion picture projectionists",0.0619409307837486,289,12.5777512197971,293,4,-6.21486074773471,288,1,-6.80954650208444,289,0,-6.82693562430236,291,2,-4.12684686556539,257,32,-3.18501261350358,266,23
468,"Child care workers",0.432513743638992,165,16.7209050244033,173,8,-0.777140325925369,161,4,-1.01520165809108,165,0,-0.792179027412078,163,2,0.0221911890841787,150,15,0.219131148569504,138,27
469," Personal service occupations, n.e.c",0.303946077823639,227,15.5132644668132,215,12,-3.33984803308885,228,1,-3.62296008662021,227,0,-3.15010189338978,218,9,-2.38485541843665,206,21,-2.10235181241748,218,9
470," Supervisors of personal service jobs, n.e.c",0.620248794555664,113,18.8330034450054,113,0,1.80529272762423,113,0,1.82800622563742,113,0,2.08623522328669,108,5,1.99606012713697,108,5,1.46542063810305,101,12
471,"Public transportation attendants and inspectors",0.430982291698456,167,16.761428560555,170,3,-0.944095202387112,170,3,-1.03305202164397,167,0,-1.30527705220052,170,3,-0.820988881900398,169,2,-0.720818695677077,171,4
472," Animal caretakers, except farm",0.322210729122162,220,15.4366689363748,218,2,-2.90000571847477,220,0,-3.21996832684045,220,0,-2.91584654103605,213,7,-2.3396149643409,203,17,-1.75582122031402,203,17
503,"Supervisors of mechanics and repairers",0.815834939479828,56,21.160456956768,62,6,5.22906131171588,57,1,5.56734164366134,56,0,5.19977367258347,61,5,4.26833025907216,62,6,3.13144504831378,60,4
505,"Automobile mechanics and repairers",0.555335104465485,133,17.7642369803429,137,4,0.561739837329908,133,0,0.536442624152566,133,0,0.0137924336262268,139,6,0.334948997855518,142,9,0.431526698546909,134,1
507," Bus, truck, and stationary engine mechanics",0.447591215372086,160,16.8875450249195,163,3,-0.807642081983104,163,3,-0.880242879349305,160,0,-1.34848560647038,173,13,-0.974081693018002,172,12,-0.54810475276997,164,4
508,"Aircraft mechanics",0.76409250497818,66,20.9290009072781,69,3,4.7388610751805,67,1,5.16776567778303,66,0,4.38504922776447,69,3,3.75447879215652,69,3,2.65536572312351,66,0
509,"Small engine repairers",0.35547199845314,195,16.0189273664474,191,4,-2.02523793091266,193,2,-2.26782753185498,195,0,-2.4181571218411,200,5,-1.5570157288573,183,12,-1.22140940179235,187,8
514,"Auto body repairers",0.243776932358742,252,14.3000051384211,254,2,-4.35989835345221,251,1,-4.79524025418083,252,0,-4.7920440974158,256,4,-4.10004918129747,255,3,-2.61473247074779,239,13
516,"Heavy equipement and farm equipment mechanics",0.353112936019897,197,15.8984453153014,203,6,-2.09159024415979,195,2,-2.33578325089041,197,0,-2.39022575591763,198,1,-2.00043995862749,195,2,-1.35129427060137,191,6
518,"Industrial machinery repairers",0.335024476051331,214,15.400058534956,220,6,-2.73280408220121,212,2,-3.03018246743242,214,0,-3.167300245235,219,5,-2.44914404533385,210,4,-1.76019775780566,204,10
519,"Machinery maintenance occupations",0.320365875959396,223,15.2545808981776,225,2,-3.03912877896771,224,1,-3.31624084417508,223,0,-3.67032508661577,230,7,-3.04946157240863,226,3,-2.09085948463321,216,7
523,"Repairers of industrial electrical equipment",0.639136672019958,106,19.1096174838066,106,0,2.10250785450539,108,2,2.28275377424573,106,0,1.49206508855664,116,10,1.00761050794805,124,18,0.681673926319247,122,16
525,"Repairers of data processing equipment",0.428899586200714,171,16.7466889840364,171,0,-1.05655669033949,171,0,-1.22264709201132,171,0,-1.62063188493512,180,9,-0.261598074464919,152,19,-0.580697167014132,165,6
526,"Repairers of household appliances and power tools",0.499534785747528,154,17.3657160093427,149,5,-0.523905065002831,155,1,-0.518901496133305,154,0,-0.970716173754273,165,11,-1.07140682853861,175,21,-1.27523171877836,189,35
527,"Telecom and line installers and repairers",0.528093755245209,144,17.6165125588417,140,4,-0.0323443719734178,144,0,-0.0328760051541616,144,0,-0.489859499257916,152,8,-0.464894884748079,157,13,-0.301225071790509,153,9
533," Repairers of electrical equipment, n.e.c.",0.618190586566925,115,18.7786755158901,115,0,1.52471004859416,116,1,1.66141111565297,115,0,1.18949920013022,124,9,1.38192619743098,116,1,0.620917289982448,124,9
534," Heating, air conditioning, and refrigeration mechanics",0.623018503189087,111,18.980704503417,110,1,1.86515434572785,112,1,1.992845695684,111,0,1.7942530361345,112,1,1.1255261118827,120,9,0.624026677811946,123,12
535," Precision makers, repairers, and smiths",0.43196764588356,166,16.8125519447803,166,0,-0.916594442160814,169,3,-1.03139506004192,166,0,-1.14544001406089,168,2,-1.16844197021178,176,10,-0.989156098898871,180,14
536,"Locksmiths and safe repairers",0.417794704437256,179,16.5720950235888,177,2,-1.49814908839053,180,1,-1.59463871944132,179,0,-1.5711757247423,178,1,-2.21556869217406,199,20,-2.29464616227711,225,46
539,"Repairers of mechanical controls and valves",0.30473455786705,225,15.2436760349393,226,1,-3.04108609101067,225,0,-3.36671858509244,225,0,-3.31541883571727,224,1,-2.74882192563004,219,6,-2.03363086803547,212,13
543,"Elevator installers and repairers",0.5378497838974,134,18.0269151016831,133,1,0.40148079680561,136,2,0.456590792127572,134,0,-0.114538560921875,145,11,0.224994991461363,147,13,-0.255655462671867,151,17
544,"Millwrights",0.582689225673676,117,18.5793779729128,118,1,1.47232952583917,117,0,1.58032223576401,117,0,1.42528316698461,120,3,0.855278762524551,126,9,0.216008583247786,139,22
549," Mechanics and repairers, n.e.c.",0.383116811513901,185,16.1619868521452,186,1,-1.82820785659487,188,3,-2.02312980614181,185,0,-2.14170308081374,191,6,-1.91418221367465,190,5,-1.26398181192891,188,3
558,"Supervisors of construction work",0.677519798278809,96,19.7362631246328,91,5,2.75021621708706,96,0,2.94467784834092,96,0,2.83159260216765,97,1,1.81549508357285,110,14,1.2749822335325,106,10
563," Masons, tilers, and carpet installers",0.269410133361816,245,14.7259981209099,238,7,-4.06433264499963,243,2,-4.44379334312082,245,0,-4.06516504567739,238,7,-3.92309924276345,247,2,-3.0012409284121,251,6
567,"Carpenters",0.412350356578827,182,16.3340239943743,182,0,-1.58230073690435,182,0,-1.7828095848341,182,0,-1.63472174224578,181,1,-1.6204977083269,185,3,-1.10563363664213,184,2
573,"Drywall installers",0.113581284880638,281,13.4863956828237,277,4,-5.57006925795717,280,1,-6.1260117202295,281,0,-5.76699737420069,278,3,-4.73432368930992,275,6,-3.22295423612776,268,13
575,"Electricians",0.567519545555115,129,18.0137191377878,134,5,0.810412168924192,130,1,0.792834508678397,129,0,0.57351015426958,133,4,0.483163389895556,136,7,0.588189722817806,126,3
577,"Electric power installers and repairers",0.531284213066101,142,17.588087143898,141,1,0.156896476885531,142,0,0.0909229690618627,142,0,-0.0822751576733791,144,2,0.239807422489052,145,3,0.20627187805396,140,2
579," Painters, construction and maintenance",0.123151138424873,276,13.811963990593,270,6,-5.43076022923549,276,0,-5.93320592207397,276,0,-5.48499585851679,273,3,-4.52216477180387,271,5,-3.20073075662807,267,9
583,"Paperhangers",0.0414368696510792,301,11.7959370405078,302,1,-7.79118283214337,301,0,-8.50771623394799,301,0,-8.15153433887761,302,1,-6.52350347022103,301,0,-4.5875543762095,303,2
584,"Plasterers",0.270107865333557,243,14.7743929629564,236,7,-4.0830547380095,244,1,-4.41984605495133,243,0,-4.03232559480303,237,6,-4.29138245883285,264,21,-3.64192986870401,281,38
585," Plumbers, pipe fitters, and steamfitters",0.391722738742828,184,16.1826370383561,185,1,-1.71897494434924,183,1,-1.93486214296268,184,0,-1.95780196653755,189,5,-1.63752671174057,187,3,-0.841495454067973,174,10
588,"Concrete and cement workers",0.163989320397377,266,14.0460710258484,260,6,-5.08069942809704,268,2,-5.47884624371522,266,0,-5.45644649865553,271,5,-5.47916890750652,287,21,-4.10668673787918,293,27
589,"Glaziers",0.168589860200882,264,13.9989990977883,262,2,-4.9742392780409,265,1,-5.44103893004038,264,0,-4.90266917201234,260,4,-4.37168022269811,266,2,-2.72364264389406,242,22
593,"Insulation workers",0.321220099925995,222,15.2667049259007,224,2,-3.01081609005161,223,1,-3.31428027131344,222,0,-3.2104054174362,222,0,-2.76809593403255,220,2,-2.13668650705181,220,2
594," Paving, surfacing, and tamping equipment operators",0.240161404013634,253,14.4179420622513,247,6,-4.49511904327087,254,1,-4.8841490766933,253,0,-4.64066272186503,250,3,-4.52005395813553,270,17,-3.14364921862344,263,10
595,"Roofers and slaters",0.373769402503967,186,16.2342140220165,183,3,-1.88838345036387,189,3,-2.04605103648593,186,0,-2.07236273913751,190,4,-1.96182518168225,194,8,-1.39525787765674,192,6
597,"Structural metal workers",0.178082212805748,258,14.1354716117501,259,1,-4.65315138303768,260,2,-5.05886039419917,258,0,-4.86849949191487,258,0,-4.1004185469696,256,2,-3.05173346238745,256,2
598,"Drillers of earth",0.274705737829208,241,14.3907221418858,250,9,-3.93558096686481,241,0,-4.3306170749215,241,0,-4.20069587455639,240,1,-2.78097285038567,221,20,-2.49143796731639,232,9
599,"Misc. construction and related occupations",0.348791241645813,199,15.9663015241623,196,3,-2.17424085255246,200,1,-2.43472142252453,199,0,-2.34349257858735,195,4,-2.28431623045197,200,1,-1.54285811930566,195,4
614,"Drillers of oil wells",0.498114824295044,155,17.075752161783,157,2,-0.535012588343972,156,1,-0.564489443528987,155,0,-0.789134516780667,162,7,-1.22293141398009,177,22,-1.04924521613879,182,27
615,"Explosives workers",0.719646692276001,84,19.9282410940886,87,3,3.20318235356366,85,1,3.57014494746743,84,0,3.1274955968726,88,4,2.34667576399675,100,16,0.997755082998628,112,28
616,"Miners",0.293450802564621,233,14.758934672904,237,4,-3.51041921310585,232,1,-3.79390600002696,233,0,-4.09605059307021,239,6,-3.2945764443838,232,1,-2.38143233891936,226,7
617,"Other mining occupations",0.0628925263881683,288,12.9220970328018,288,0,-6.25144026637011,289,1,-6.78315778079224,288,0,-6.64184646273654,290,2,-5.61738754587156,290,2,-4.28520268378756,297,9
628,"Production supervisors or foremen",0.617012798786163,116,18.5216370004177,119,3,1.69521259327771,114,2,1.64291212615406,116,0,1.64455818132385,114,2,2.34459702008514,101,15,2.12493259668982,80,36
634,"Tool and die makers and die setters",0.580202400684357,118,18.7336071330786,116,2,1.39228696807741,118,0,1.542588809599,118,0,1.62967333256568,115,3,1.10757369219772,121,3,-0.0846501184894952,146,28
637,"Machinists",0.51172548532486,148,17.2722530310392,153,5,-0.223531628625597,148,0,-0.280402942196856,148,0,-0.558800582197005,154,6,-0.885771819782349,171,23,-0.965143557779868,178,30
643,"Boilermakers",0.502333760261536,149,17.4764659006596,144,5,-0.297161790521348,153,4,-0.309431091116754,149,0,-0.599560509880405,157,8,-0.837699207332828,170,21,-0.638153393653332,167,18
644,"Precision grinders and fitters",0.430345267057419,169,17.0842402454138,156,13,-1.09758958759227,172,3,-1.10790601892005,169,0,-1.31734790658887,172,3,-2.92187873363446,224,55,-2.54675065665996,237,68
645,"Patternmakers and model makers",0.321796178817749,221,15.4334487321615,219,2,-2.97431565301177,221,0,-3.25901885772875,221,0,-3.16939003219897,221,0,-2.56797017557009,214,7,-2.49860098183728,233,12
649,"Engravers",0.243926018476486,251,14.2782020701408,256,5,-4.39343017722983,252,1,-4.76972960744038,251,0,-4.72667855952921,254,3,-4.13411520913874,258,7,-3.48203586795087,277,26
653,"Other metal and plastic workers",0.417488396167755,180,16.4194440892816,180,0,-1.5812704041441,181,1,-1.71794185122658,180,0,-1.77489575644287,185,5,-1.92965309535625,191,11,-1.61741089219395,198,18
657,"Cabinetmakers and bench carpeters",0.42048305273056,176,16.6474091259003,174,2,-1.36524334956739,178,2,-1.46468193862857,176,0,-1.52681221328374,175,1,-1.94089379502108,193,17,-1.72580800338251,201,25
658," Furniture/wood finishers, other prec. wood workers",0.130782067775726,270,13.3015950923085,284,14,-5.07861517178485,267,3,-5.64157961859192,270,0,-5.80811059600835,279,9,-3.89929816692961,245,25,-2.44261577837486,230,40
666," Dressmakers, seamstresses, and tailors",0.1766307502985,259,14.169788155663,258,1,-4.64353397468752,258,1,-5.07570255126522,259,0,-4.74981046713859,255,4,-4.29832837255978,265,6,-3.40572080565897,273,14
668,"Upholsterers",0.392625749111176,183,16.2150682107806,184,1,-1.73201999444243,184,1,-1.92659122251809,183,0,-1.78541732002994,186,3,-1.9400085280759,192,9,-1.68369626357015,199,16
669," Shoemakers, other prec. apparel and fabric workers",0.0252782329916954,313,10.284357143151,313,0,-9.6531278779973,313,0,-10.5941070295166,313,0,-10.0613248443022,313,0,-8.04311835565916,313,0,-5.04718233134053,309,4
675," Hand molders and shapers, except jewelers",0.291816681623459,234,15.0023095429182,231,3,-3.51617961511221,233,1,-3.82579663030863,234,0,-3.87074132329903,234,0,-3.2286191593593,230,4,-2.75402839455767,245,11
677,"Optical goods workers",0.555830538272858,132,18.2547190766335,128,4,0.601827786530158,132,0,0.629233894895551,132,0,0.880701849387243,130,2,0.369689338238324,140,8,-0.0851238399229366,147,15
678,"Dental laboratory and medical applicance technicians",0.568090260028839,128,18.23886217556,129,1,0.9015799999006,129,1,0.982778659953658,128,0,0.602270195544373,132,4,0.316923847116125,143,15,0.0895286156139019,142,14
679,"Bookbinders",0.359909325838089,192,15.9108310399815,202,10,-2.03201892030171,194,2,-2.21697366332586,192,0,-2.55727732013843,204,12,-2.32544286005807,201,9,-1.75440538239587,202,10
686,"Butchers and meat cutters",0.0322279632091522,310,11.3754780878037,309,1,-8.34556752864088,310,0,-9.14319198371264,310,0,-8.62136874485441,309,1,-7.20433898514629,309,1,-5.23320903015729,311,1
687,"Bakers",0.173249453306198,261,13.8916430112481,266,5,-4.59253937549397,257,4,-5.15175201055857,261,0,-4.89111003356108,259,2,-3.54982445659554,237,24,-2.12686476383461,219,42
688,"Batch food makers",0.274979710578918,240,14.5600500223517,244,4,-3.91464550036382,239,1,-4.22736417642932,240,0,-4.39270560467084,246,6,-3.97846782601425,250,10,-3.03199970580705,252,12
694,"Water and sewage treatment plant operators",0.571121335029602,124,18.5911009124756,117,7,1.04607421708573,127,3,1.17081358176232,124,0,0.896864875061342,128,4,0.408358015421464,139,15,-0.0906665107535833,148,24
695,"Power plant operators",0.715559482574463,87,19.7139384465456,92,5,2.95349885684321,92,5,3.25267366317878,87,0,2.47411142491248,103,16,2.16836819026773,105,18,1.25343464284137,107,20
696," Plant and system operators, stationary engineers",0.537483215332031,135,18.0876819466114,132,3,0.254912339981263,140,5,0.387257095016221,135,0,-0.248039152275972,146,11,-0.455097996866272,156,21,-0.362798964137659,157,22
699,"Other plant and system operators",0.574887096881866,120,18.376670484519,125,5,1.31981827663926,122,2,1.44067296361808,120,0,0.624710236400807,131,11,0.342432267721346,141,21,0.506537599876712,129,9
703," Lathe, milling, and turning machine operatives",0.252192556858063,248,14.6623751639962,241,7,-4.19843928896291,249,1,-4.55987843368647,248,0,-4.51954388677784,248,0,-3.91133578797593,246,2,-3.04695355622041,254,6
706,"Punching and stamping press operatives",0.298501312732697,231,15.0188770083725,230,1,-3.46804522474426,231,0,-3.7471670446235,231,0,-3.84061897721758,231,0,-3.68368138742725,240,9,-2.75649685033997,246,15
707," Rollers, roll hands, and finishers of metal",0.4247807264328,174,16.5870961318254,175,1,-1.14026510496638,174,0,-1.2536769475647,174,0,-1.61277083549089,179,5,-1.49978316289028,181,7,-0.987674024552913,179,5
708,"Drilling and boring machine operators",0.339691907167435,206,15.9191429908991,201,5,-2.42108504412715,206,0,-2.63061139250774,206,0,-2.52952187315809,203,3,-2.54089318428742,211,5,-2.00329727217975,211,5
709," Grinding, abrading, buffing, and polishing workers",0.424456983804703,175,16.7918222419262,167,8,-1.29986452591337,177,2,-1.34521811879098,175,0,-1.70025545935505,183,8,-2.39268493670177,208,33,-1.71376495408604,200,25
713,"Forge and hammer operators",0.24880214035511,249,14.3410641175985,252,3,-4.24926623929403,250,1,-4.59901939896799,249,0,-4.71311256776295,253,4,-3.92956121441107,248,1,-3.06904345731016,257,8
719,"Molders and casting machine operators",0.0412176437675953,302,11.6241085641831,304,2,-7.79791280773022,302,0,-8.51930787042413,302,0,-8.32819656847067,306,4,-6.9431127562924,308,6,-4.79288168139542,306,4
723,"Metal platers",0.0528155006468296,296,12.33388121562,297,1,-6.8726326216442,296,0,-7.52872828918846,296,0,-7.65761915662335,299,3,-5.72288690945407,295,1,-3.79518378412452,284,12
724,"Heat treating equipment operators",0.346034646034241,200,15.6116872013569,211,11,-2.22409310175815,202,2,-2.45327058438939,200,0,-2.69501476782392,210,10,-2.57341050656321,215,15,-1.76354320084772,205,5
727,"Sawing machine operators and sawyers",0.0577173829078674,291,12.684192043227,291,0,-6.30208843330189,291,0,-6.92449494530667,291,0,-6.90243745092299,292,1,-5.71123269815684,294,3,-3.49127364807665,278,13
729," Nail, tacking, shaping and joining mach ops (wood)",0.178214028477669,257,13.908337076056,265,8,-4.64544123164295,259,2,-5.03717500429798,257,0,-5.33940912403551,268,11,-4.92477398021252,279,22,-3.30011719745928,270,13
736,"Typesetters and compositors",0.349349737167358,198,15.9545617172837,199,1,-2.17977654904642,201,3,-2.41374790044153,198,0,-2.6004800401982,208,10,-1.77534083111624,189,9,-1.54298055356005,196,2
738,"Winding and twisting textile and apparel operatives",0.275485187768936,239,14.706539152801,239,0,-3.92462532821596,240,1,-4.22484376528935,239,0,-4.28456853157679,242,3,-4.28366854070206,263,24,-3.31660352846385,271,32
739," Knitters, loopers, and toppers textile operatives",0.0328107960522175,308,11.2800171391726,310,2,-8.26438374984974,308,0,-9.01405780133058,308,0,-8.83526239682739,310,2,-6.80794045908932,306,2,-4.8649127771349,307,1
743,"Textile cutting and dyeing machine operators",0.335810333490372,211,15.652777184689,209,2,-2.80028094752489,216,5,-2.96245830673308,211,0,-3.16822880543841,220,9,-3.58054328072949,239,28,-2.890510614344,249,38
744,"Textile sewing machine operators",0.0422300845384598,300,11.8211330731988,301,1,-7.6333890684781,300,0,-8.40811260940097,300,0,-8.0618383324348,301,1,-6.68454459016593,303,3,-4.30000115434145,299,1
745,"Shoemaking machine operators",0.123454093933105,275,13.6116711498067,273,2,-5.42456982344313,275,0,-5.91351679884646,275,0,-5.66106271896056,276,1,-5.04285048222283,282,7,-3.78637720196371,283,8
747,"Clothing pressing machine operators",0.00198523211292922,316,9.62899501143694,316,0,-10.9380414870221,316,0,-11.8949801679634,316,0,-11.6283931297876,316,0,-9.61330453265661,316,0,-7.20398173193168,317,1
753,"Cementing and gluing machine operators",0.264564901590347,246,14.4003039962411,249,3,-4.09515598951511,245,1,-4.481805096855,246,0,-4.63926874992857,249,3,-4.03519495443724,252,6,-2.52707249889016,234,12
754," Packers, fillers, and wrappers",0.276409327983856,238,14.6662320180535,240,2,-3.85409636617104,238,0,-4.18435283442516,238,0,-4.24228425708096,241,3,-4.06182260788157,253,15,-3.37061851660259,272,34
755,"Extruding and forming machine operators",0.299836874008179,229,15.1057930812955,228,1,-3.41302315400598,230,1,-3.68863769580239,229,0,-3.87984554972439,235,6,-3.77185376143711,242,13,-2.65136991796898,241,12
756,"Mixing and blending machine operators",0.354895025491714,196,16.0325856851578,190,6,-2.16348498648153,198,2,-2.33424355006182,196,0,-2.55977123625,205,9,-2.73454038824595,218,22,-2.07947368213308,215,19
757," Separating, filtering, and clarifying machine operators",0.529343962669373,143,17.453307499218,145,2,-0.0138874665752528,143,0,0.018325224136861,143,0,-0.610067565841118,159,16,-0.660836978577452,163,20,-0.758352731231832,173,30
763,"Food roasting and baking machine operators",0.07061468064785,285,12.7974970806718,289,4,-5.82931267951998,286,1,-6.46377621858375,285,0,-6.4467055766275,288,3,-4.28091176212321,262,23,-2.59962866363866,238,47
764," Washing, cleaning, and pickling machine operators",0.032341580837965,309,11.408259061563,307,2,-8.34188138556167,309,0,-9.12508314523311,309,0,-8.92983991789927,311,2,-7.29876352601728,311,2,-4.99296292977244,308,1
765,"Paper folding machine operators",0.233473241329193,255,14.359620165956,251,4,-4.47995262429893,253,2,-4.89637127960327,255,0,-4.92092935438465,261,6,-4.08930938942152,254,1,-2.83836325409621,247,8
766," Furnance, kiln, and oven operators, apart from food",0.175955921411514,260,14.023722276026,261,1,-4.76186267092286,261,1,-5.13200805915866,260,0,-5.38518688654281,270,10,-4.68830416792013,274,14,-3.4069378797457,274,14
769," Slicing, cutting, crushing and grinding machine",0.171959385275841,263,13.860281720382,268,5,-4.93598708994017,263,0,-5.33718595603094,263,0,-5.32737194795688,267,4,-4.55537926293858,273,10,-3.47472155749967,276,13
774,"Photographic process workers",0.29917311668396,230,14.8867629146576,234,4,-3.36606394873529,229,1,-3.7183965219675,230,0,-3.85811940643939,232,2,-2.71076414026932,217,13,-1.89180355025187,209,21
779," Machine operators, n.e.c.",0.111968606710434,283,13.3117821335673,282,1,-5.81373253632512,285,2,-6.28278399423132,283,0,-6.36090938762927,287,4,-5.44317625008301,286,3,-4.24931839847343,295,12
783," Welders, solderers, and metal cutters",0.0837009847164154,284,13.3079272651494,283,1,-5.80699177655415,283,1,-6.30872820129918,284,0,-6.29632670908783,285,1,-5.44240235619097,285,1,-3.69348614578063,282,2
785,"Assemblers of electrical equipment",0.319566279649734,224,15.3043238143921,223,1,-3.09112100028823,226,2,-3.35461900265526,224,0,-3.50267778516088,227,3,-2.92085217734817,223,1,-2.27376759767474,223,1
789,"Painting and decoration occupations",0.162893190979958,267,13.9803583286107,263,4,-5.12445533270947,269,2,-5.52963874136044,267,0,-5.36698539163191,269,2,-5.14209871243167,283,16,-3.94250575707073,288,21
799," Production checkers, graders, and sorters in manufacturing",0.370903491973877,190,15.9929070176005,195,5,-1.94951940348822,191,1,-2.15160834918437,190,0,-2.42633826922436,202,12,-2.00913766079018,196,6,-1.05152222720118,183,7
803,"Supervisors of motor vehicle transportation",0.569230020046234,126,18.3251162354946,127,1,1.10259003051577,125,1,1.10241816977071,126,0,1.21040960754905,123,3,0.851717106309986,127,1,0.610198535771775,125,1
804," Truck, delivery, and tractor drivers",0.23325714468956,256,14.2949997175992,255,1,-4.52612415219524,256,0,-4.94588117497982,256,0,-4.64109941424761,251,5,-4.39878688940967,267,11,-3.10806249479876,258,2
808,"Bus drivers",0.126723289489746,274,13.6027401202343,274,0,-5.46132901127446,277,3,-5.90634524894016,274,0,-5.73119751496227,277,3,-5.70661084098564,292,18,-4.31943946439167,300,26
809,"Taxi cab drivers and chauffeurs",0.280850410461426,236,14.9861230144739,232,4,-3.67791224935981,236,0,-4.05848868296593,236,0,-3.61627130877197,229,7,-3.76715515367712,241,5,-2.53867174352149,236,0
813,"Parking lot attendants",0.0547437630593777,293,12.4192290095568,296,3,-6.6346261345916,293,0,-7.31221214023159,293,0,-7.16204552797069,294,1,-6.24826627094724,299,6,-4.29162426821004,298,5
823,"Railroad conductors and yardmasters",0.500577628612518,153,16.9081569180727,162,9,-0.257928051473458,150,3,-0.475084145861436,153,0,-0.529943039737871,153,0,0.593499931243696,135,18,0.786495128674475,120,33
824,"Locomotive operators: engineers and firemen",0.36162668466568,191,15.9599684946477,198,7,-1.99500970064217,192,1,-2.15985380495567,191,0,-2.31985944416037,194,3,-2.07386599525235,197,6,-1.49961364443989,193,2
825," Railroad brake, coupler, and switch operators",0.337424963712692,210,15.6271160590649,210,0,-2.79113165662134,215,5,-2.9338212477037,210,0,-3.10585904706842,217,7,-3.33243305262032,233,23,-2.53757650990656,235,25
829,"Ship crews and marine engineers",0.57638418674469,119,18.4421320034027,120,1,1.32844789646877,121,2,1.44761386026158,119,0,0.909168172363867,127,8,0.696631166976452,131,12,0.4977276156265,131,12
834,"Miscellanious transportation occupations",0.678208887577057,93,19.9506929445744,85,8,2.90048067026827,93,0,3.06397239153399,93,0,2.93013534986592,94,1,2.22512015056932,102,9,1.40579972892149,104,11
844,"Operating engineers of construction equipment",0.274283528327942,242,14.5759878598571,243,1,-4.12061122091242,246,4,-4.41742432678848,242,0,-4.50130204444297,247,5,-3.84532409891175,244,2,-2.90462859887158,250,8
848," Crane, derrick, winch, hoist, longshore operators",0.296425670385361,232,15.0848355641484,229,3,-3.54220913827471,234,2,-3.78515760878584,232,0,-3.88001008451082,236,4,-4.01391014242154,251,19,-3.11718148190524,259,27
853,"Excavating and loading machine operators",0.128205761313438,273,13.4307576781571,280,7,-5.32950997837529,273,0,-5.81963737749989,273,0,-5.82617125244046,280,7,-4.91260232280846,278,5,-3.25670169142222,269,4
859,"Stevedores and misc. material moving occupations",0.359689295291901,193,16.0011958693385,194,1,-2.12591085068042,197,4,-2.24509036787658,193,0,-2.56655627684649,207,14,-2.43776564209547,209,16,-1.98100918266061,210,17
865," Helpers, constructions",0.278061628341675,237,14.6371869472146,242,5,-3.75608322693815,237,0,-4.09772656461676,237,0,-4.33741818087037,244,7,-3.4530923647258,235,2,-2.40285181380549,228,9
866," Helpers, surveyors",0.11212270706892,282,13.5272287807971,275,7,-5.8098332495296,284,2,-6.26998074585438,282,0,-6.01629042024553,283,1,-5.62517489693907,291,9,-4.52376024760257,301,19
869,"Construction laborers",0.26424503326416,247,14.4421515717387,246,1,-4.17212913722688,247,0,-4.53653079223876,247,0,-4.31141806084623,243,4,-3.56016847301416,238,9,-3.13925670325017,262,15
873,"Production helpers",0.0543581061065197,294,12.6137280427098,292,2,-6.87136762578431,295,1,-7.41858773796896,294,0,-7.21017348021622,296,2,-6.42604878645417,300,6,-5.04894089365934,310,16
875,"Garbage and recyclable material collectors",0.0478686131536961,298,12.2040568954229,298,0,-7.14360730106422,298,0,-7.84747676908943,298,0,-7.49858287598655,297,1,-6.04660138111282,297,1,-4.12550532837901,294,4
878,"Machine feeders and offbearers",0.116526648402214,278,13.4705500524402,279,1,-5.57413442555704,281,3,-6.00299200391945,278,0,-6.26870916996528,284,6,-5.29051928650224,284,6,-3.9944789871976,290,12
885,"Garage and service station related occupations",0.0617739781737328,290,12.928898131597,287,3,-6.28477458822834,290,0,-6.92215194782407,290,0,-6.52080697255424,289,1,-5.53565608828002,288,2,-3.94898385066509,289,1
887,"Vehicle washers and equipment cleaners",0.00161011074669659,317,8.65270602052659,317,0,-12.0940987336125,317,0,-13.2662707914394,317,0,-12.3683957007977,317,0,-10.0991130686153,317,0,-6.23560113320146,316,1
888,"Packers and packagers by hand",0.0393966287374496,303,12.0288990370274,300,3,-8.11008123992283,307,4,-8.70110863544462,303,0,-8.26379202231105,305,2,-7.8900996069879,312,9,-6.21397381758815,314,11
889," Laborers, freight, stock and material handlers, n.e.c.",0.161235600709915,269,13.7619655459166,271,2,-5.13021760434223,270,1,-5.60684661165645,269,0,-5.48632097015803,274,5,-4.76013894860022,276,7,-3.17353164087341,264,5
